Bitcoin: BTC
Ethereum: ETH
Tether: USDT
BNB: BNB
Solana: SOL
USDC: USDC
XRP: XRP
Dogecoin: DOGE
Toncoin: TON
TRON: TRX
Cardano: ADA
Avalanche: AVAX
Shiba Inu: SHIB
Chainlink: LINK
Polkadot: DOT
Bitcoin Cash: BCH
Dai: DAI
UNUS SED LEO: LEO
Litecoin: LTC
NEAR Protocol: NEAR
Kaspa: KAS
Internet Computer: ICP
Uniswap: UNI
Artificial Superintelligence Alliance: FET
Pepe: PEPE
Monero: XMR
Aptos: APT
POL (ex-MATIC): POL
Stellar: XLM
Ethereum Classic: ETC
Render: RENDER
Sui: SUI
First Digital USD: FDUSD
Stacks: STX
OKB: OKB
Bittensor: TAO
Cronos: CRO
Filecoin: FIL
Aave: AAVE
Immutable: IMX
Hedera: HBAR
Injective: INJ
Mantle: MNT
Arbitrum: ARB
Optimism: OP
VeChain: VET
Cosmos: ATOM
dogwifhat: WIF
Maker: MKR
The Graph: GRT
THORChain: RUNE
Fantom: FTM
Bitget Token: BGB
Arweave: AR
Theta Network: THETA
Helium: HNT
FLOKI: FLOKI
Bonk: BONK
Polygon: MATIC
Algorand: ALGO
Pyth Network: PYTH
Jupiter: JUP
JasmyCoin: JASMY
Sei: SEI
KuCoin Token: KCS
Bitcoin SV: BSV
Celestia: TIA
MANTRA: OM
Lido DAO: LDO
Quant: QNT
Ondo: ONDO
Core: CORE
Flow: FLOW
BitTorrent: BTT
Brett (Based): BRETT
Notcoin: NOT
PayPal USD: PYUSD
EOS: EOS
Flare: FLR
GateToken: GT
USDD: USDD
MultiversX: EGLD
Starknet: STRK
Axie Infinity: AXS
Popcat (SOL): POPCAT
Beam: BEAM
ORDI: ORDI
Neo: NEO
Worldcoin: WLD
SATS: 1000SATS
Tezos: XTZ
Gala: GALA
Tether Gold: XAUt
Nervos Network: CKB
eCash: XEC
Conflux: CFX
Akash Network: AKT
The Sandbox: SAND
dYdX (Native): DYDX
Ethereum Name Service: ENS